..##_#####_##..
..#,,,,#,,,,#..
###,---#---,###
#s-g,,,#,,,,,,#
#,-,,,,#,f,--,#
#,-,--,#,,-,-,#
#,-,-,,#,-,,-,#
#,-,-,,#,,,,-,#
#,-,-,,#,,-,-,#
#,-,-,,#,-,,-,#
#,-,-f,#-,,,-,#
#,-,---#,,g,-,#
#,,,,,,#,,,,-,#
------,#,----s#
..#p,,,#,,,p---
..#,,,,#,,,,-..
..-----------..