...............#######
...............#,,,,,#
...............#,,,f,#
...########_####,,,,,#
...#,,f,,,,,,,,,,,---#
...#,,,,,,,,,,,,,,,s,#
...#,,,,,,,,,,,,,-,,,#
...#,,,,,,,,,,,,,----#
...#,,,,,,,,,,,t,,,,,#
...#--,,--,--,,,,,,,,#
####,,,,-,s,---,,,,,,#
#,,,,,,f-,,,-,,,,,,,,#
#,,,,,,,-----,,,p,,,,#
#g,,,,,,,,,,-,,,,,,,,#
#,,,,,,,,,,,,,,,,,,,,#
#,,,,,,,,,,,,,,,,,,,,#
----------------------