...#######........
...#,,,,,#........
...#,s,,,#........
...#,,,,,###_#####
...#,,,,,,-,,,,,f#
####---,,,-,,,,,,#
#,,,,,-t,,,,,----#
#,f,,,-,,,,,,,,,,#
#,,,,,,,,,,,,,,,,#
#,,,,,,f,,,,,,,,,#
#-,,---,,,,g,,,,,#
,-s,-,-,,,,,,,p,,#
,-,,-,-,,,,,,,,,,#
,----,-----------#