.###_###...............
.#,,,,,#...............
.#,p,,,#...............
.#,,,,,#...############
.#,,,,,#..##,s,-,,,,,,#
##f--,,###,#,,,-f,,,,,#
#,,,,,,,,,t,-,,-,,,,,,#
#,,,,,,,,,,,,,,,,,,,,,#
#,,,,,,,,,,,,,,,,,,,,,#
#----,,,,,,,,,,,,,,g,,#
....-,,,,,,,,,,,,,,,,,#
....-,,,------,,,,,,,,#
....-,,,,,s,,----------
....-,,,-,,,,-.........
....-,,,------.........
....-,,,,,-............
....-,,,f,-............
....-------............