...########.......
...#......#.......
...#.g....#.......
...#......###_####
...#......-.....f#
####---...-......#
#.....-t.........#
#.f...-..........#
#................#
#......f.........#
-------..........#
......-.......p..#
......-..........#
......------------