.##___##...............
.#.....#...............
.#.p...#...............
.#.....#.......########
.#.....#.......#......#
##f--..####....#.f....#
#.........######......#
#...........t.......g.#
#.....................#
#.........------......#
#........f-....-......#
#.........-....--------
#.........-............
-----------............