...............#######
...............#.....#
...............#..f..#
...##########_##.....#
...#..f..............#
...#.................#
...#.................#
...#...........t..---#
...#.................#
...#----.............#
####........---......#
#...........-........#
#...........-..p.....#
#g..f.......-........#
#....................#
#....................#
----------------------