#####
#   #####
#       #
#       #
#########